#######################################
#--@----------------------------------#
#-------------------------------------#
#-------------------------------------#
#-------------------------------------#
#-------------------------------------#
#-------------------------------------#
#-------------------------------------#
#-------------------------------------#
#-------------------------------------#
#-------------------------------------#
#-------------------------------------#
#######################################