#################################################
#H_@__#_________________________________________#
#_____#_________________________________________#
####__#_________________________________________#
#__________________________________s____________#
#_____________________s_________________________#
#_______________________________________________#
#_________________O_____________________________#
#_______________________________________________#
#_____b_________________________________________#
#_______________________________________________#
#__b____________________________O_______________#
#_______________________________________________#
#_______________________________________________#
#________b_____O________________________________#
#_______________________________________________#
#____________________________________O__________#
#________b_____________________________________D#
#################################################